#.#..&##..
...##.#...
##..#.#..#
.##...&...
..##@###.#
.###.#..#.
###..##.##
.#&.##...#
.##..####.
.##...#.##